XXXXXXXXXXXXXXXXXXXXXXXXXXXXXXXXXXXXXXXXXXXXXXXXXXX
P     X         X     X     X   X X           X   X
X XXX XXXXX X X X XXX X X X X X X X XXXXX XXX X X X
X X X X     X X   X   X X X X X X X X   X X   X X X
X X X X XXXXX XXXXX XXX X X X X X X XXX X X XXXXX X
X   X   X   X     X X   X X   X   X X   X X       X
XXX XXXXX X X XXX X XXXXX X XXXXXXX X XXX XXXXXXX X
X X X   X X X   X X       X X           X       X X
X X X X XXX XXX X XXXXXXXXXXX XXXXXXXXX XXXXXXX X X
X X   X   X   X X   X       X X         X     X X X
X XXXXXXX X X X XXX X XXXXX X XXXXX XXX XXXXX X XXX
X X     X X X   X   X X   X X   X   X X X     X   X
X X X X X X XXXXX XXX XXX X XXX X XXX X X XXX XXX X
X X X X X X     X X   X   X X   X   X X X X X   X X
X X X XXX X XXX X X XXX XXX X XXX X X X X X XXX X X
X   X     X X X   X X     X   X   X X     X     X X
X XXXXXXXXX X XXX X X XXX XXXXX XXX X XXXXXXX XXX X
X X         X     X X X   X   X X   X   X   X X   X
X XXXXXXX XXX XXX X XXX XXX X X X XXX XXX X XXX X X
X X     X X   X   X   X     X     X   X   X     X X
X X XXX X XXXXX X XXX X XXXXXXXXX X XXX XXXXXXXXX X
X   X X X X     X   X X     X   X X X X X     X   X
XXXXX X X X XXXXX X X XXXXX X XXX X X X XXX XXX XXX
X       X   X X   X X       X   X X   X   X       X
X XXX XXX XXX X XXXXX X XXXXX X X XXXXXXX XXXXXXX X
X   X X       X       X   X   X X X   X   X   X   X
X X X XXXXXXX XXXXXXXXXXX X XXX X X X X XXX X X XXX
X X X     X X   X X   X   X X   X X X X X   X X   X
X X XXXXX X XXX X X X X XXXXX X X X X X X XXX XXXXX
X X     X X   X X X X         X     X X     X     X
X XXXXX X XXX X X X XXXXXXXXXXXXXXX X XXXXXXX XXX X
X   X X X   X X X     X           X X   X   X X   X
XXX X X XXX X X X XXXXX XXXXXXXXX XXX X X X XXX X X
X   X X   X X X X X     X         X   X X X X   X X
X XXX X XXX X X XXX XXXXX XXXXXXXXX XXX X X X XXXXX
X X   X     X       X     X         X X X X   X   X
X X X XXXXXXXXXXXXXXX XXXXXXX XXXXXXX X X XXXXX X X
X X X       X     X X   X   X X       X X     X X X
X XXXXXXX X X XXX X XXX X X X X XXX XXX XXXXX X X X
X       X X   X   X       X   X   X         X   X X
XXXXXXX X XXXXX XXX XXXXXXXXXXXXXXXXXXXXXXXXX XXX X
X     X   X   X X   X   X     X   X     X   X   X X
X XXXXXXXXX XXX X XXX X X XXX X X X XXX X X XXXXX X
X     X     X   X     X X   X   X   X X   X       X
X XXX X X XXX XXXXXXXXX XXX XXXXXXXXX XXXXXXXXXXX X
X X X   X X   X   X     X X X         X     X     X
X X XXXXX X XXX X X XXXXX X XXXXX XXX X X XXX XXXXX
X   X       X   X X       X       X   X X     X   X
XXX X XXX X X XXXXXXXXXXX XXXXX X XXXXX XXXXXXXXX X
X   X X X X X   X       X X     X     X X         X
X XXX X X X X X X X XXX X X XXXXX XXX X XXX X XXX X
X   X X X X X X   X   X X X   X X   X X   X X X   X
XXX X X X X X XXXXXXX XXX XXX X XXX X XXX XXX X XXX
X X X X   X X     X X       X X   X X     X   X X X
X X X XXXXX XXXXX X XXXXXXXXX X X X XXXXXXX XXX X X
X   X   X   X         X       X X   X       X     X
XXXXXXX X XXXXXXXXXXX X XXX XXXXX XXXXXXX XXXXXXX X
X   X   X         X X X X   X   X         X   X   X
X X X X XXXXXXXXX X X X XXXXX X XXXXXXXXXXX X XXXXX
X X   X   X     X X X X       X             X     X
X XXXXXXX X XXX X X X XXXXXXXXXXXXXXXXXXXXXXXXXXX X
X X     X X   X   X X                     X     X X
X X XXX XXXXX XXXXX XXX XXXXXXX XXXXX XXXXX XXX X X
X   X X     X X       X X   X   X   X X   X X     X
X XXX XXXXX X XXX XXX X X X XXXXX X XXX X X XXXXX X
X     X X   X   X X X X X X X     X X   X X   X   X
XXXXX X X XXXXX X X X X X X X XXXXX X XXX XXX XXXXX
X   X   X     X X X   X X X   X X   X   X   X     X
X XXXXX XXX XXX X XXXXX X XXXXX X XXXXX XXX X XXX X
X       X X     X     X X     X   X     X   X   X X
X XXXXXXX XXXXXXXXX X X XXXXX X XXX XXXXX XXXXX X X
X X   X           X X   X   X X     X     X     X X
X X X XXXXX XXXXX X XXXXX X X XXXXXXX XXXXX XXXXX X
X X X X   X     X X X X   X   X     X X     X     X
X X X X X XXXXX X X X X XXX XXX X XXX XXXXXXX XXX X
X   X   X     X X X   X X X   X X   X     X   X   X
XXXXXXXXXXX X X X XXX X X X X X XXX XXXXX X XXX XXX
X   X       X   X X   X X   X   X   X     X X   X X
X XXX XXX X XXXXX XXXXX X XXXXXXX XXX XXXXX X XXX X
X X   X   X   X   X     X X     X     X     X   X X
X X XXX XXXXX X XXX X XXX XXXXX XXXXXXX X X XXX X X
X X X   X     X     X   X     X         X X X   X X
X X X XXX XXXXXXXXXXX XXXXXXX X XXX XXXXX X X XXX X
X   X   X   X   X     X     X   X   X   X X X X   X
X XXX X XXX X X X XXX X X XXX X XXX X X X X X X XXX
X   X X   X   X   X X X X     X   X X X X   X X   X
XXX X XXX XXXXXXXXX X X XXXXXXX X XXX X XXXXX X X X
X       X   X X     X X X   X X X     X X     X X X
X XXXXXXXXX X X XXX X X X X X X XXXXXXX X XXXXXXX X
X X       X X     X X X   X X   X                 X
XXX XXXXX X X XXX X X XXXXX X XXX XXXXXXXXXXXXXXX X
X   X       X     X       X X X   X     X         X
X X XXXXXXXXX XXXXXXXXXXX X X X XXX X X X XXXXXXXXX
X X X   X     X     X   X X X X X   X X X   X     X
X XXX X XXX XXX XXX X X XXX XXX X XXX XXXXX XXXXX X
X X   X   X   X X X X X   X   X X   X     X X   X X
X X XXXXX X XXX X X X XXX XXX X XXX XXXXX X X X X X
X   X     X X   X X   X X   X X X X X X   X X X X X
X XXX XXXXXXX XXX X XXX X XXX X X X X X XXX X X X X
X                       X       X     X       X   K
XXXXXXXXXXXXXXXXXXXXXXXXXXXXXXXXXXXXXXXXXXXXXXXXXXX
